111111111111111111111
1E0000000000C000C0001
101010010000010110101
101001010101000110101
1P0000C00C000000000C1
111111111111111111111
